111111111111111111111
111111111100000011111
1P0101100010000011111
10001C110110000011111
100000000100000011111
111011100C01000011111
111111110000000011111
10000000C000C00011111
1000000C0CEC0C1111111
10000000C00000C011111
111111111111111111111